1 4 1
10 4
11 9
-1 02 03 03 03 03 03 03 03 04 -1
-1 11 23 23 23 23 23 23 23 12 -1
-1 11 00 00 00 00 00 00 00 12 -1
28 01 00 00 00 00 00 00 00 05 29
24 23 00 00 00 00 00 00 00 23 25
30 06 00 00 00 00 00 00 00 10 31
-1 11 00 00 00 00 00 00 00 12 -1
-1 11 00 00 00 00 00 00 00 12 -1
-1 07 08 08 08 08 08 08 08 09 -1
8
2 4 3 2 3 3
2 6 3 3 3 3
2 6 5 0 3 3
2 4 5 1 3 3
2 3 2 2 5 5
2 7 2 3 5 5
2 7 6 0 5 5
2 3 6 1 5 5
5
5 4
2 1
8 1
2 7
8 7